11111111111111111111111111111111
1P000000000000000000000000000C01
111011111011100010111101000E0001
11111111111111111111111111111111