111111111111111111111111111111111111111111111111111111111111111111111
1P0000C00000111110000CCC000001000000000000000000000000000000000000001
111011111011100010111101111101000000000000000000000000000000000000001
1000100000100010CCC001010C0001000000000000000000000000000000000000001
101110111110111011110101111101000000000000000000000000000000000000001
10000010CCCCC00010000101000C01000001000111110001111100011111000101001
111110101111111111110111011101000001000000010000000100000001000000001
100010101000000000010000010001000001000111110001111100000001010000101
101110101011101111011111011101000001000000010000000100000001001111001
100C00101010001000010000000001000001000000010000000100000001000000001
101110111010111011110111111101000001000111110001111100000001000000001
1000100000100000000101000C0001000000000000000000000000000000000000001
101111111111101111110111011101000000000000000000000000000000000000001
10000000000100100000C000010001000000000000000000000000000000000000001
1C1111101111111011111110111101000000000000000000000000000000000000001
1000001000CCCCC0C00000100000E1000000000000000000000000000000000000001
111111111111111111111111111111111111111111111111111111111111111111111
