11111111111
1P0000W0111
11100C0C0E1
11111111111
