111111111111111111111111
1P00000C00000CCCCC010001
101111111111101111101011
10100CCC0000101000001001
101011111101101011111101
101000001111001000000101
101111101101101111101101
100000101000CCC000001001
111101101011101110101001
1C000C00010000001010C001
111101111010111101011111
100001000000000101000001
101111111111101101111101
101000C00001101001000001
101011111101101111001101
1C000000101000C000011001
111101101111101111111001
100000101000000000001E11
111111111111111111111111
