111111111111111
1PC0000000000C1
101111011111101
101000010000101
101011011101101
101000010100001
101110010111101
100010010100001
101110010111101
101000010000101
101011011101101
10C0000E0000C01
111111111111111