11111111111
1P000000111
11100C0C0E1
11111111111
