111111111111111111111111111111
1P0000C00000111110000CCC000001
111111111011100000111101111101
1000100000000010CCC001010C0001
101110111110111011110101111101
10000010CCCCC000100W0101000C01
111110101111111111110111011101
100010101000000000010000010001
101110101011101111011111011101
100C00101010001000010000000001
101110111010111011111111111101
10001000001000000W01C1000C0001
101111111111101011111110011101
100001C10001001000100000000001
1C1111101111111111011110101101
1000001000000000C000W000000E11
111111111111111111111111111111
