11111111111
10P0C0E0111
11W0C0C1001
11111111111
