11111111111
1000C0E0101
110PC0C1001
11111111111
