11111111111111111111111111111111
111P01111111111111111111100E1111
11110011111111111111111100011111
11111011111111111110000001111111
111110C0111111111100W11101111111
11111110001111111001111101111111
1111111110111111C000111101111111
111111110001111111101111000W1111
11110000010111111110111111000111
11100W11110111111100111111100111
11001111110111111001111111001111
1100W01111CCCCCCCC11111100011111
11111111111111111111100000011111
11111111110000011111000111111111
11111111111111111000111111111111
11111111111111111111111111111111
