1111111111111111111111111111111111111111111111
1C000111P001C011111111111111111111111111000011
1111011111011011111111111111111111111110011011
111100111C011000000000000000000000000000111011
1111101111011110111111111111111111111111111011
1111101111000C10111011100001110000111E00011011
1111001110011110111011111101111110111111011011
1100011110111110111011100001110000111111011011
1101111C00111110111011111101111110111111011011
110111111000C110111011100001110000111111011011
1100011100111111111111111111111111110CC0011011
1101111C00000CC00000CCC0000CC00000000111111011
11CCCC0000111011111111111111111111111111111011
111111C111111011111111111111111111111111111011
111111C111111000000000000000000000000000000011
1111111111111111111111111111111111111111111111