1111111
1P10001
1010001
1010001
1000E01
1C00001
1111111