11111111111
10P0C0E0111
1110C0C1001
11111111111
